NASD MARKET MAKER/ECN/EXCHANGE CODES	

ABLE	ARNHOLD & S. BLEICHRODER
ABNA	ABN AMRO
ADAM	ADAMS HARKNESS
ADFN	ADFN
ADVS	ADVEST
AGED	A.G. EDWARDS
AGIS	AEGIS CAP. CORP
ALLN	"ALLEN & CO., INC"
AMEX	AMEX
ARCA	ARCHIPELAGO	YES
ATTN	ATTAIN
BAMM	BAMM
BARD	ROBERT W. BAIRD
BBNT	SCOTT & STRINGF
BERN	SANFORD C BERNSTEIN
BEST	BEAR STEARNS
BRUS	H.D. BROUS & CO.
BRUT	BRASS UTILITY	YES
BTRD	BLOOMBERG TRADE	YES
BWNC	STC SECS CORP
CANT	CANTOR FITZ
CEUT	UNTERBERG HARRIS
CIBC	CIBC WORLD MARKETS
CINN	CINN. STOCK EXCHANGE
COWN	SG COWEN SECURITIES
DADA	D.A. DAVIDSON
DAIN	DAIN BOSWORTH
DBAB	DEUTSCHE BANK
DELA	DELAFIELD & HAM
DKRW	DRESDNER KLEINWORT WASSERSTEIN
DLCR	D.L. CROMWELL
EKNS	EHRENKRANTZ
FACT	FIRST ALBANY
FAHN	FAHNESTOCK & CO
FBCO	FIRST BOSTON CORP
FBRC	FREIDMAN BILLINGS RAMSAY
FPKI	FOX-PITT KELTON
FSWC	FIRST SOUTHWEST
GGET	GARBAN GIORGIO
GKMC	GERARD KLAUER
GRAM	GRAMERCY GROUP
GSCO	GOLDMAN SACHS
GVRC	GVR COMPANY
GUAR	GUARDIAN SECURITIES
HRCO	HUBERMAN RILEY
HSBC	HSBC SECURITIES
ILND	Island	YES
INCA	Instinet	YES
ITEC	INVESTEC INC.
JANY	JANNEY MONTGOMERY SCOTT
JBOC	JB OXFORD
JEFF	JEFFRIES & CO.
JPHQ	JP MORGAN CHASE
KBRO	KAUFMAN BROS LP
KBWI	KEEFE BRUYETTE & WOODS
LAZA	LAZARD FRERES
LEER	LEERINK SWANN
LEGG	LEGG MASON
LEHM	LEHMAN BROS.
LSPD	MARKETXT INC.
LTCO	"LADENBURG, THALMAN"
LYON	CREDIT LYONNAISE
MADF	BERNARD L MADOF
MCBT	MOORS & CABOT
MDLD	MCDONALD & CO.
MHMY	M.H. MYERSON
MLCO	MERRILL LYNCH
MOKE	MORGAN KEEGAN
MONT	MONTGOMERY SECS.
MRLN	MARLINS CAPITAL
MSCO	MORGAN STANLEY
MTCO	MILLER TABAK
MWRI	MWRI
MWSE	MIDWEST STOCK EXCHANGE
NAIB	N AMER INSTL B
NATY	NATCITY INVESTMENTS
NBSI	NESBITT BURNS
NEED	NEEDHAM & CO.
NFSC	NAT'L FIN SVC CP
NITE	KNIGHT SECURITIES
NTRD	PIM GLOBAL EQ
OGRU	OSCAR GRUSS
OTAA	OTA LTD PARTNERS
PACS 	PACIFIC CREST
PERT	PERSHING TRADING
PGON	PARAGON CAP CORP
PIPR	PIPER JAFFRAY
PRGM	PROGRAM TRADING
PRUS	PRUDENTIAL SECURITIES
PTLV	PUTMAN LOVELL
PUNK	PUNK ZIEGEL
RAJA	RAYMOND JAMES
RAMS	RAMIUS SECURITIES
RHCO	SUNTRUST CAPITAL MARKETS
RYAN	"RYAN, BECK & CO."
SBSH	SMITH BARNEY
SCHB	MAYER & SCHWEITZER
SETS	Archipelago	YES
SIZE	SIZE
SNDS	SANDS BROTHERS
SNDV	SOUNDVIEW FINANCIAL
SPHM	"STEPHENS, INC."
SUSQ	SUSQUEHANNA
SWST	SOUTHWEST SECURITIES
TDCM	TD WATERHOUSE
TJAS	TEJAS SECURITIES
TMBR	TIMBER HILL L.L.C.
TRAC	Track	YES
TWPT	THOMAS WEISEL PARTNERS
UBSW	UBSW
VNDM	VAN DHAM SECURITIES
WAIN	H.C. WAINWRIGHT
WBLR	WILLIAM BLAIR
WCAI	WINDSOR CAP ADV
WCHV	FIRST UNION SECURITIES
WDCO	WILSON-DAVIS
WEDB	WEDBUSH MORGAN
WEED	WEEDEN AND CO.
WELS	WELLS FARGO SECURITIES
WIEN	WIEN SECS CORP
WRHC	WILLIAMS R HOUG
WRTH	WORTHINGTON SECURITIES
